"MASTER	M AE S T ER
A	AH
A(2)	EY
ARE?	AA R
BUBBLE	B AH B AH L
CAN	K AE N
CAN(2)	K AH N
COFFEE	K AA F IY
COFFEE(2)	K AO F IY
DO	D UW
FIND	F AY N D
GET	G EH T
GET(2)	G IH T
GOOGLE	G UW G AH L
HA-HA-HA	HH AA HH AA HH AA
I	AY
IT	IH T
KIFT	K IH F T
LIGHT	L AY T
LOVE	L AH V
ME	M IY
ME?	M IY
OF	AH V
OFF	AO F
OKAY	OW K EY
ON	AA N
ON(2)	AO N
OPEN	OW P AH N
PLAY	P L EY
PREEVâ€™AT	P R IY EH V AH T
PUPPETS"	P AH P AH T S
SAFARI	S AH F AA R IY
SET	S EH T
SHUTDOWN	SH AH T D AW N
STOP	S T AA P
STORY	S T AO R IY
STUPID	S T UW P AH D
STUPID(2)	S T UW P IH D
TEA?	T IY
TELL	T EH L
TIMER	T AY M ER
TURN	T ER N
WHERE	W EH R
WHERE(2)	HH W EH R
WHO	HH UW
YOU	Y UW
